xxxxxxxxxxxxxxxxxxxxxxxxxxxxxxxxxxxxxxxxxxxxxxxxxxxxxxxxxxxxxxxxxxxxxxxxxxx
x                                                                         x
x                                                                         x
x                 XX                     XX                               x
x                 XX                     XX                               x
x                                                                         x
x                                                                         x
x                                                                         x
x                                                                         x
x                                                                         x
x                  XXXXXXXXXXXXXXXXXXXXXXX                                x
x                                                                         x
x                                                                         x
x                                                                         x
x                                                                         x
x                                                                         x
xxxxxxxxxxxxxxxxxxxxxxxxxxxxxxxxxxxxxxxxxxxxxxxxxxxxxxxxxxxxxxxxxxxxxxxxxxx